11111111111111111111111111111111111111111
1CE01111111111111111111111111111111111111
1P001111111111111111111111111111111111111
11111111111111111111111111111111111111111