1111111111111
1001000000101
1000011110001
1P0011E000101
1111111111111