111111111111111111111
1P0C00C00C00C00C00C01
111111111111111111001
100C00C00C00C00C00C01
101111111111111111101
100C00C00C00C00C00001
111111111111111111C01
100C00C00C00C00C00C01
101111111111111111101
100C00C00C00C00C00001
111111111111111111C01
1EC00C00C00CCCCCC0001
111111111111111111001
111111111111111111001
111111111111111111001
111111111111111111001
111111111111111111001
111111111111111111001
111111111111111111001
111111111111111111001
111111111111111111001
111111111111111111111